D10000000000000
010111110111110
010100010100010
011111011111010
010000010001010
010111010111010
010101010100010
011101010101110
000001000101000
011111011101110
000000010000010
011111111111010
010001000001010
0111011101110A0
000000000000010